{
    "case_sensetive": false,
    "characters": {
        "A": "A_ps2p",
        "B": "B_ps2p",
        "C": "C_ps2p",
        "D": "D_ps2p",
        "E": "E_ps2p",
        "F": "F_ps2p",
        "G": "G_ps2p",
        "H": "H_ps2p",
        "I": "I_ps2p",
        "J": "J_ps2p",
        "K": "K_ps2p",
        "L": "L_ps2p",
        "M": "M_ps2p",
        "N": "N_ps2p",
        "O": "O_ps2p",
        "P": "P_ps2p",
        "Q": "Q_ps2p",
        "R": "R_ps2p",
        "S": "S_ps2p",
        "T": "T_ps2p",
        "U": "U_ps2p",
        "V": "V_ps2p",
        "W": "W_ps2p",
        "X": "X_ps2p",
        "Y": "Y_ps2p",
        "Z": "Z_ps2p",
        "1": "1_ps2p",
        "2": "2_ps2p",
        "3": "3_ps2p",
        "4": "4_ps2p",
        "5": "5_ps2p",
        "6": "6_ps2p",
        "7": "7_ps2p",
        "8": "8_ps2p",
        "9": "9_ps2p",
        "0": "0_ps2p",
        "?": "_question_ps2p",
        ".": "_dot_ps2p",
        ",": "_comma_ps2p",
        ":": "_colon_ps2p",
        "!": "_exclamation_ps2p",
        ")": "_closeparenthesis_ps2p",
        "(": "_openparenthesis_ps2p",
        "\"_close": "_closequotes_ps2p",
        "\"_open": "_openquotes_ps2p",
        "'_open": "_openapostrophe_ps2p",
        "'_close": "_closeapostrophe_ps2p",
        " ": "_space_ps2p"
    }
}